{
    "tubes": [
        ["r", "t", "t", "y"],
        ["d", "d", "d", "y"],
        ["r", "r", "d", "b"],
        ["g", "g", "g", "b"],
        ["b", "y", "y", "p"],
        ["t", "t", "p", "p"],
        ["b", "g", "r", "p"],
        []
    ]
}
